5,5,5,4,4,4,4,4,4,4,4,4,4,3,3,1,5,5
5,5,5,4,4,4,4,4,4,4,4,4,4,3,3,1,1,5
5,1,1,1,1,1,1,1,1,1,1,1,6,1,3,1,1,1
1,S1,1,1,1,4,4,4,4,4,4,4,1,1,1,1,1,1
S1,1,S1,1,1,4,4,4,4,4,4,4,1,1,1,1,1,1
1,S1,1,S1,1,1,1,1,1,1,1,1,6,1,1,1,1,1
1,S1,1,S1,1,4,4,4,4,4,4,4,1,1,1,1,1,1
S1,1,S1,1,1,4,4,4,4,4,4,4,1,1,1,1,1,1
1,S1,1,S1,1,1,1,1,1,1,1,1,6,1,6,6,6,6
5,1,1,1,1,4,4,4,4,4,4,4,4,4,6,1,1,1
5,5,5,1,1,4,4,4,4,4,4,4,4,4,6,1,8,5
5,5,5,5,5,5,5,5,5,5,5,5,5,5,6,1,5,5
0,0,0,0,0,0,0,0,0,0,0,0,0,0,0,0,0,0
5,5,1,1,1,1,1,4,1,3,3,1,1,5,5,0,0,0
5,1,1,1,1,1,1,4,1,3,3,1,1,8,5,0,0,0
1,1,1,1,1,1,1,4,1,1,1,1,1,1,1,0,0,0
1,1,1,6,6,6,5,5,5,5,5,5,1,1,1,0,0,0
1,1,1,6,1,1,5,5,5,5,5,5,1,1,1,0,0,0
1,1,1,6,1,6,6,1,1,1,5,5,1,1,1,0,0,0
1,1,1,5,5,6,2,2,2,1,5,5,1,1,1,0,0,0
4,4,4,5,5,1,2,7,2,1,5,5,4,4,4,0,0,0
1,1,1,5,5,1,2,2,2,6,5,5,1,1,1,0,0,0
1,1,1,5,5,1,1,1,6,6,1,6,1,1,1,0,0,0
3,3,1,5,5,5,5,5,5,1,1,6,1,1,1,0,0,0
3,3,1,5,5,5,5,5,5,6,6,6,1,1,1,0,0,0
1,1,1,1,1,1,1,4,1,1,1,1,1,1,1,0,0,0
5,1,1,1,1,1,1,4,1,1,1,1,1,1,5,0,0,0
5,5,1,1,1,1,1,4,1,1,1,1,1,5,5,0,0,0
