2,7,7,3,3,3,3,3,3,3,3,3,3,3,3,3,3,3,1,1
7,7,3,3,3,3,3,3,3,3,3,3,3,3,3,3,3,3,3,1
3,3,3,3,3,3,3,3,3,3,3,3,3,3,3,3,3,3,3,3
7,1,7,1,7,1,7,3,3,7,7,7,3,3,3,5,5,1,1,1
1,7,1,7,1,7,1,3,3,7,7,7,3,3,3,5,1,1,4,4
7,1,7,1,7,1,7,2,2,7,7,7,2,2,2,1,1,1,1,4
1,7,1,7,1,7,1,3,3,7,7,7,3,3,3,1,1,1,4,4
7,1,7,1,7,1,7,3,3,7,7,7,3,3,3,1,1,1,1,1
3,3,3,3,3,3,3,3,3,3,3,3,3,3,3,3,1,3,3,3
3,3,3,3,3,3,3,3,3,3,3,3,2,3,3,3,1,3,3,3
3,3,3,3,3,3,3,3,3,3,3,3,1,3,1,1,1,1,1,1
1,1,1,1,1,1,1,3,1,1,1,1,1,3,2,2,1,S1,1,S1
1,3,1,1,1,1,1,3,1,1,1,1,1,3,1,1,S1,1,S1,1
1,3,1,7,7,7,1,2,1,7,7,7,1,1,1,2,1,S1,1,S1
1,1,2,7,7,7,2,2,2,7,7,7,2,2,1,1,S1,1,S1,1
