5,5,5,5,5,4,4,4,4,5,5,5,5
5,5,5,4,4,4,1,4,4,4,5,5,5
4,5,5,4,1,1,1,1,4,4,4,5,5
4,5,5,4,1,1,1,1,1,1,4,4,5
4,4,4,4,1,1,1,1,1,1,1,1,1
1,1,4,4,6,6,6,1,1,1,1,1,1
1,1,1,1,1,1,1,1,6,6,6,1,1
1,1,1,1,1,1,1,1,1,1,1,1,1
1,1,2,1,1,1,1,1,1,1,1,1,1
2,2,3,3,3,3,1,1,1,6,6,6,1
3,3,3,3,3,3,1,1,1,6,1,1,1
3,3,3,3,2,1,1,1,2,1,1,1,1
3,3,3,1,2,1,1,1,1,1,1,1,1
2,2,1,2,1,1,1,2,1,1,1,1,1
1,1,1,1,1,2,2,1,1,1,1,1,1
1,1,1,1,1,1,1,1,1,1,1,1,1
1,1,1,1,1,1,6,1,2,1,1,1,1
1,1,1,1,1,1,6,1,1,2,1,1,1
2,1,1,1,1,1,1,1,1,1,1,2,1
1,1,1,1,1,1,2,2,1,1,1,1,1
