5,5,5,5,5,5,5,5,5,5,5,5,5,5,5,5,5,5,5,5,5,5,5,5,5
5,5,1,1,1,7,7,7,7,7,7,2,7,7,7,7,1,1,1,1,1,1,1,1,1
5,1,1,1,1,7,7,7,7,7,7,2,7,7,7,1,1,1,1,1,1,1,1,1,1
5,1,1,1,1,7,7,7,7,7,7,1,1,1,1,1,1,1,1,1,1,1,1,1,1
4,1,1,1,1,5,5,1,7,1,1,1,1,1,2,2,2,2,2,2,2,1,1,5,5
4,1,2,2,2,5,5,1,1,2,2,2,2,2,2,1,1,1,1,1,2,1,1,1,5
4,1,1,1,2,5,5,1,1,2,2,2,2,2,2,1,7,7,7,1,2,5,1,1,1
4,4,1,1,1,5,5,2,2,2,1,1,1,1,7,1,1,1,7,1,2,5,5,1,1
5,4,1,1,1,5,5,2,2,7,7,7,1,1,7,1,1,1,1,1,2,5,1,1,1
5,4,1,1,1,1,1,2,2,7,1,7,1,1,1,1,1,2,2,2,2,1,1,1,5
5,5,1,1,1,1,1,2,2,1,1,1,1,1,1,1,1,2,1,1,1,1,1,1,5
5,5,5,1,4,4,4,2,2,2,2,2,2,2,2,2,2,2,1,1,1,1,1,5,5
5,5,5,1,1,1,1,1,1,1,1,1,4,4,4,4,4,4,1,1,1,1,1,5,5
5,5,5,5,5,5,5,5,5,4,4,4,4,2,2,2,2,4,5,5,5,5,5,5,5
